//MAP CONVERTED BY dmm2tgm.py THIS HEADER COMMENT PREVENTS RECONVERSION, DO NOT REMOVE
"a" = (
/turf/open/lava/smooth/lava_land_surface,
/area/space)
"b" = (
/obj/machinery/door/firedoor,
/turf/open/lava/smooth/lava_land_surface,
/area/space)
"c" = (
/obj/machinery/atmospherics/components/unary/outlet_injector/on/layer4{
	dir = 8;
	volume_rate = 200;
	piping_layer = 1
	},
/turf/open/lava/smooth/lava_land_surface,
/area/space)
"d" = (
/obj/structure/grille,
/turf/open/lava/smooth/lava_land_surface,
/area/space)
"f" = (
/obj/machinery/atmospherics/pipe/layer_manifold/visible,
/turf/open/floor/engine,
/area/space)
"g" = (
/turf/open/floor/iron,
/area/space)
"j" = (
/turf/closed/wall/mineral/plastitanium/nodiagonal,
/area/space)
"k" = (
/turf/open/floor/engine,
/area/space)
"l" = (
/obj/machinery/atmospherics/components/trinary/filter/on{
	piping_layer = 1;
	dir = 4
	},
/turf/open/floor/engine,
/area/space)
"n" = (
/turf/open/floor/carpet/grimy,
/area/space)
"o" = (
/obj/machinery/door/firedoor,
/turf/open/floor/carpet/grimy,
/area/space)
"q" = (
/obj/effect/spawner/structure/window/plasma/reinforced,
/obj/structure/grille,
/turf/open/floor/iron,
/area/space)
"r" = (
/obj/effect/spawner/structure/window/hollow/plasma/reinforced/directional{
	dir = 8
	},
/turf/open/floor/engine,
/area/space)
"s" = (
/obj/machinery/door/airlock/engineering/glass/critical{
	req_access_txt = "150";
	name = "Lavaland Syndicate Engineering"
	},
/turf/open/floor/iron,
/area/space)
"t" = (
/obj/machinery/atmospherics/components/unary/vent_scrubber/on/layer4{
	piping_layer = 1
	},
/turf/open/floor/engine,
/area/space)
"w" = (
/obj/structure/table/wood,
/obj/item/ammo_box/magazine/m10mm,
/turf/open/floor/carpet/grimy,
/area/space)
"B" = (
/obj/effect/spawner/structure/window/hollow/plasma/reinforced/directional{
	dir = 4
	},
/turf/open/floor/engine,
/area/space)
"C" = (
/obj/machinery/atmospherics/components/unary/thermomachine/freezer{
	dir = 4;
	initialize_directions = 4
	},
/turf/open/floor/engine,
/area/space)
"E" = (
/obj/machinery/atmospherics/pipe/manifold/general/hidden/layer5{
	piping_layer = 1
	},
/turf/open/floor/engine,
/area/space)
"F" = (
/obj/machinery/light/small{
	dir = 1
	},
/turf/open/floor/carpet/grimy,
/area/space)
"I" = (
/obj/machinery/power/supermatter_crystal/shard/hugbox{
	radio_key = /obj/item/encryptionkey/syndicate;
	name = "syndicate supermatter shard";
	desc = "It costed alot of money for your benefactors to buy this."
	},
/turf/open/floor/engine,
/area/space)
"J" = (
/obj/structure/closet/radiation,
/turf/open/floor/iron,
/area/space)
"K" = (
/turf/open/lava/smooth/lava_land_surface,
/turf/open/lava/smooth/lava_land_surface,
/area/space)
"L" = (
/obj/machinery/atmospherics/components/unary/vent_pump/on{
	dir = 1;
	piping_layer = 1
	},
/turf/open/floor/engine,
/area/space)
"M" = (
/obj/structure/closet/gimmick/tacticool,
/turf/open/floor/carpet/grimy,
/area/space)
"N" = (
/obj/machinery/light_switch/directional/west,
/turf/open/floor/carpet/grimy,
/area/space)
"P" = (
/turf/open/space/basic,
/turf/open/lava/smooth/lava_land_surface,
/area/space)
"Q" = (
/obj/machinery/atmospherics/pipe/manifold/general/hidden/layer1{
	piping_layer = 2;
	dir = 11
	},
/turf/open/floor/engine,
/area/space)
"T" = (
/obj/machinery/airalarm/syndicate{
	dir = 8;
	pixel_x = -24
	},
/turf/open/floor/carpet/grimy,
/area/space)
"U" = (
/obj/effect/mob_spawn/human/lavaland_syndicate/comms{
	dir = 8
	},
/obj/structure/bed{
	layer = 2.5
	},
/obj/item/bedsheet/syndie{
	layer = 1.5
	},
/turf/open/floor/carpet/grimy,
/area/space)
"W" = (
/obj/effect/spawner/structure/window/hollow/plasma/reinforced/directional{
	dir = 1
	},
/obj/machinery/atmospherics/pipe/manifold/general/visible/layer4{
	piping_layer = 1;
	dir = 8
	},
/turf/open/floor/engine,
/area/space)
"Z" = (
/obj/effect/spawner/structure/window/hollow/plasma/reinforced/directional,
/turf/open/floor/engine,
/area/space)

(1,1,1) = {"
a
a
a
a
a
a
a
a
a
a
a
a
a
a
a
a
a
a
a
a
a
a
a
a
a
a
a
a
a
a
a
a
a
a
a
a
a
a
a
a
a
a
a
a
a
a
a
a
a
a
"}
(2,1,1) = {"
a
a
a
a
a
a
a
a
a
a
a
a
a
a
a
a
a
a
a
a
a
a
a
a
a
a
a
a
a
a
a
a
a
a
a
a
a
a
a
a
a
a
a
a
a
a
a
a
a
a
"}
(3,1,1) = {"
a
a
a
a
a
a
a
a
a
a
a
a
a
a
a
a
a
a
a
a
a
a
a
a
a
a
a
a
a
a
a
a
a
a
a
a
a
a
a
a
a
a
a
a
a
a
a
a
a
a
"}
(4,1,1) = {"
a
a
a
a
a
a
a
a
a
a
a
a
a
a
a
a
a
a
a
a
a
a
a
a
a
a
a
a
a
a
a
a
a
a
a
a
a
a
a
a
a
a
a
a
a
a
a
a
a
a
"}
(5,1,1) = {"
a
a
a
a
a
a
a
a
a
a
a
a
a
a
a
a
a
a
a
a
a
a
a
a
a
a
a
a
a
a
a
a
a
a
a
a
a
a
a
a
a
a
a
a
a
a
a
a
a
a
"}
(6,1,1) = {"
a
a
a
a
a
a
a
a
a
a
a
a
a
a
a
a
a
a
a
a
a
a
a
a
a
a
a
a
a
a
a
a
a
a
a
a
a
a
a
a
a
a
a
a
a
a
a
a
a
a
"}
(7,1,1) = {"
a
a
a
a
a
a
a
a
a
a
a
a
a
a
a
a
a
a
a
a
a
a
a
a
a
a
a
a
a
a
a
a
a
a
a
a
a
a
a
a
a
a
a
a
a
a
a
a
a
a
"}
(8,1,1) = {"
a
a
a
a
a
a
a
a
a
a
a
a
a
a
a
a
a
a
a
a
a
a
a
a
a
a
a
a
a
a
a
a
a
a
a
a
a
a
a
a
a
a
a
a
a
a
a
a
a
a
"}
(9,1,1) = {"
a
a
a
a
a
a
a
a
a
a
a
a
a
a
a
a
a
a
a
a
a
a
a
a
a
a
a
P
P
a
a
a
a
a
a
a
a
a
a
a
a
a
a
a
a
a
a
a
a
a
"}
(10,1,1) = {"
a
a
a
a
a
a
a
a
a
a
a
a
a
a
a
a
a
a
a
a
a
a
a
a
a
a
a
a
a
a
a
a
a
a
a
a
a
a
a
a
a
a
a
a
a
a
a
a
a
a
"}
(11,1,1) = {"
a
a
a
a
a
a
a
a
a
a
a
a
a
a
a
a
a
a
a
a
a
a
a
a
a
a
a
a
a
a
a
a
a
a
a
a
a
a
a
a
a
a
a
a
a
a
a
a
a
a
"}
(12,1,1) = {"
a
a
a
a
a
a
a
a
a
a
a
a
a
a
a
a
a
a
a
a
a
a
a
a
a
a
a
a
a
a
a
a
a
a
a
a
a
a
a
a
a
a
a
a
a
a
a
a
a
a
"}
(13,1,1) = {"
a
a
a
a
a
a
a
a
a
a
a
a
a
a
a
a
a
a
a
a
a
a
a
a
a
a
a
a
a
a
a
a
a
a
a
a
a
a
a
a
a
a
a
a
a
a
a
a
a
a
"}
(14,1,1) = {"
a
a
a
a
a
a
a
a
a
a
a
a
a
a
a
a
a
a
a
a
a
a
a
a
a
a
a
a
a
a
a
a
a
a
a
a
a
a
a
a
a
a
a
a
a
a
a
a
a
a
"}
(15,1,1) = {"
a
a
a
a
a
a
a
a
a
a
a
a
a
a
a
a
a
a
a
a
a
a
a
a
a
a
a
a
a
a
a
a
a
a
a
a
a
a
a
a
a
a
a
a
a
a
a
a
a
a
"}
(16,1,1) = {"
a
a
a
a
a
a
a
a
a
a
a
a
a
a
a
a
a
a
a
a
a
a
a
P
a
a
a
a
a
a
a
a
a
a
a
a
a
a
a
a
a
a
a
a
a
a
a
a
a
a
"}
(17,1,1) = {"
a
a
a
a
a
a
a
a
a
a
a
a
a
a
a
a
a
a
a
a
a
a
a
K
a
a
a
a
a
a
a
a
a
a
a
a
a
a
a
a
a
a
a
a
a
a
a
a
a
a
"}
(18,1,1) = {"
a
a
a
a
a
a
a
a
a
a
a
a
a
a
a
a
a
a
a
a
a
a
a
K
a
a
a
a
a
a
a
a
a
a
a
a
a
a
a
a
a
a
a
a
a
a
a
a
a
a
"}
(19,1,1) = {"
a
a
a
a
a
a
a
a
a
a
a
a
a
a
a
a
a
a
a
a
a
a
P
P
a
a
a
a
a
a
a
a
a
a
a
a
a
a
a
a
a
a
a
a
a
a
a
a
a
a
"}
(20,1,1) = {"
a
a
a
a
a
a
a
j
j
j
j
j
j
j
a
a
a
a
a
a
a
a
P
a
a
a
a
a
a
a
a
a
a
a
a
a
a
a
a
a
a
a
a
a
a
a
a
a
a
a
"}
(21,1,1) = {"
a
a
a
a
a
a
j
j
B
B
B
C
C
j
j
a
a
a
a
a
a
a
P
a
a
a
a
a
a
a
a
a
a
a
a
a
a
a
a
a
a
a
a
a
a
a
a
a
a
a
"}
(22,1,1) = {"
a
a
a
a
a
a
j
Z
L
I
t
W
Q
k
j
j
a
a
a
a
a
a
a
a
a
a
a
a
a
a
a
a
a
a
a
a
a
a
a
a
a
a
a
a
a
a
a
a
a
a
"}
(23,1,1) = {"
a
a
a
a
a
a
j
k
r
r
r
k
l
f
Q
j
a
a
a
a
a
a
a
a
a
a
a
a
a
a
a
a
a
a
a
a
a
a
a
a
a
a
a
a
a
a
a
a
a
a
"}
(24,1,1) = {"
a
a
a
a
a
a
j
k
k
k
k
k
k
k
E
j
a
a
a
a
a
a
a
a
a
a
a
a
a
a
a
a
a
a
a
a
a
a
a
a
a
a
a
a
a
a
a
a
a
a
"}
(25,1,1) = {"
a
a
a
a
a
a
j
k
k
k
k
k
g
g
g
q
g
g
g
g
g
g
g
g
g
g
g
a
a
a
a
a
a
a
a
a
a
a
a
a
a
a
a
a
a
a
a
a
a
a
"}
(26,1,1) = {"
a
a
a
a
a
a
j
k
k
k
k
k
g
g
g
s
g
g
g
g
g
g
g
g
g
g
g
a
a
a
a
a
a
a
a
a
a
a
a
a
a
a
a
a
a
a
a
a
a
a
"}
(27,1,1) = {"
a
a
a
a
a
a
j
k
k
k
k
k
g
g
g
q
g
g
g
g
g
g
g
g
g
g
g
a
a
a
a
a
a
a
a
a
a
a
a
a
a
a
a
a
a
a
a
a
a
a
"}
(28,1,1) = {"
a
a
a
a
a
a
j
k
k
k
k
k
g
g
J
j
a
a
g
g
g
g
g
g
g
g
g
a
a
a
a
a
a
a
a
a
a
a
a
a
a
a
a
a
a
a
a
a
a
a
"}
(29,1,1) = {"
a
a
a
a
a
a
j
k
k
k
k
k
g
g
J
j
a
a
g
g
g
g
g
g
g
g
g
a
a
a
a
a
a
a
a
a
a
a
a
a
a
a
a
a
a
a
a
a
a
a
"}
(30,1,1) = {"
a
a
a
a
a
a
j
k
k
k
k
k
g
J
j
j
a
a
g
j
j
j
j
g
g
g
g
a
a
a
a
a
a
a
a
a
a
a
a
a
a
a
a
a
a
a
a
a
a
a
"}
(31,1,1) = {"
a
a
a
a
a
a
j
j
k
k
k
k
g
j
j
a
n
a
g
j
T
N
o
g
g
g
g
a
a
a
a
a
a
a
a
a
a
a
a
a
a
a
a
a
a
a
a
a
a
a
"}
(32,1,1) = {"
a
a
a
a
a
a
a
j
j
j
j
j
j
j
a
a
b
a
g
j
F
M
j
g
g
g
g
a
a
a
a
a
a
a
a
a
a
a
a
a
a
a
a
a
a
a
a
a
a
a
"}
(33,1,1) = {"
a
a
a
a
a
a
a
a
a
a
a
a
c
a
a
a
j
a
g
j
n
n
j
g
g
g
g
a
a
a
a
a
a
a
a
a
a
a
a
a
a
a
a
a
a
a
a
a
a
a
"}
(34,1,1) = {"
a
a
a
a
a
a
a
a
a
a
a
a
a
a
a
a
d
a
g
j
U
w
j
g
g
g
g
a
a
a
a
a
a
a
a
a
a
a
a
a
a
a
a
a
a
a
a
a
a
a
"}
(35,1,1) = {"
a
a
a
a
a
a
a
a
a
a
a
a
a
a
a
a
a
a
g
j
j
j
j
g
g
g
g
a
a
a
a
a
a
a
a
a
a
a
a
a
a
a
a
a
a
a
a
a
a
a
"}
(36,1,1) = {"
a
a
a
a
a
a
a
a
a
a
a
a
a
a
a
a
a
a
g
g
g
g
g
g
g
g
g
a
a
a
a
a
a
a
a
a
a
a
a
a
a
a
a
a
a
a
a
a
a
a
"}
(37,1,1) = {"
a
a
a
a
a
a
a
a
a
a
a
a
a
a
a
a
a
a
g
g
g
g
g
g
g
g
g
a
a
a
a
a
a
a
a
a
a
a
a
a
a
a
a
a
a
a
a
a
a
a
"}
(38,1,1) = {"
a
a
a
a
a
a
a
a
a
a
a
a
a
a
a
a
a
a
a
a
a
a
a
a
a
a
a
a
a
a
a
a
a
a
a
a
a
a
a
a
a
a
a
a
a
a
a
a
a
a
"}
(39,1,1) = {"
a
a
a
a
a
a
a
a
a
a
a
a
a
a
a
a
a
a
a
a
a
a
a
a
a
a
a
a
a
a
a
a
a
a
a
a
a
a
a
a
a
a
a
a
a
a
a
a
a
a
"}
(40,1,1) = {"
a
a
a
a
a
a
a
a
a
a
a
a
a
a
a
a
a
a
a
a
a
a
a
a
a
a
a
a
a
a
a
a
a
a
a
a
a
a
a
a
a
a
a
a
a
a
a
a
a
a
"}
(41,1,1) = {"
a
a
a
a
a
a
a
a
a
a
a
a
a
a
a
a
a
a
a
a
a
a
a
a
a
a
a
a
a
a
a
a
a
a
a
a
a
a
a
a
a
a
a
a
a
a
a
a
a
a
"}
(42,1,1) = {"
a
a
a
a
a
a
a
a
a
a
a
a
a
a
a
a
a
a
a
a
a
a
a
a
a
a
a
a
a
a
a
a
a
a
a
a
a
a
a
a
a
a
a
a
a
a
a
a
a
a
"}
(43,1,1) = {"
a
a
a
a
a
a
a
a
a
a
a
a
a
a
a
a
a
a
a
a
a
a
a
a
a
a
a
a
a
a
a
a
a
a
a
a
a
a
a
a
a
a
a
a
a
a
a
a
a
a
"}
(44,1,1) = {"
a
a
a
a
a
a
a
a
a
a
a
a
a
a
a
a
a
a
a
a
a
a
a
a
a
a
a
a
a
a
a
a
a
a
a
a
a
a
a
a
a
a
a
a
a
a
a
a
a
a
"}
(45,1,1) = {"
a
a
a
a
a
a
a
a
a
a
a
a
a
a
a
a
a
a
a
a
a
a
a
a
a
a
a
a
a
a
a
a
a
a
a
a
a
a
a
a
a
a
a
a
a
a
a
a
a
a
"}
(46,1,1) = {"
a
a
a
a
a
a
a
a
a
a
a
a
a
a
a
a
a
a
a
a
a
a
a
a
a
a
a
a
a
a
a
a
a
a
a
a
a
a
a
a
a
a
a
a
a
a
a
a
a
a
"}
(47,1,1) = {"
a
a
a
a
a
a
a
a
a
a
a
a
a
a
a
a
a
a
a
a
a
a
a
a
a
a
a
a
a
a
a
a
a
a
a
a
a
a
a
a
a
a
a
a
a
a
a
a
a
a
"}
(48,1,1) = {"
a
a
a
a
a
a
a
a
a
a
a
a
a
a
a
a
a
a
a
a
a
a
a
a
a
a
a
a
a
a
a
a
a
a
a
a
a
a
a
a
a
a
a
a
a
a
a
a
a
a
"}
(49,1,1) = {"
a
a
a
a
a
a
a
a
a
a
a
a
a
a
a
a
a
a
a
a
a
a
a
a
a
a
a
a
a
a
a
a
a
a
a
a
a
a
a
a
a
a
a
a
a
a
a
a
a
a
"}
(50,1,1) = {"
a
a
a
a
a
a
a
a
a
a
a
a
a
a
a
a
a
a
a
a
a
a
a
a
a
a
a
a
a
a
a
a
a
a
a
a
a
a
a
a
a
a
a
a
a
a
a
a
a
a
"}
