//MAP CONVERTED BY dmm2tgm.py THIS HEADER COMMENT PREVENTS RECONVERSION, DO NOT REMOVE
"aT" = (
/obj/effect/mob_spawn/human/lavaland_syndicate/comms{
	dir = 8
	},
/obj/structure/bed{
	layer = 2.5
	},
/turf/open/floor/carpet/grimy,
/area/space)
"bF" = (
/obj/structure/table/wood,
/obj/machinery/reagentgrinder,
/obj/item/kitchen/rollingpin,
/obj/item/knife/kitchen{
	pixel_x = 6
	},
/turf/open/floor/wood,
/area/space)
"bV" = (
/obj/effect/mapping_helpers/simple_pipes/orange/visible/layer2{
	piping_layer = 3
	},
/obj/effect/spawner/structure/window/hollow/plasma/reinforced/directional{
	dir = 8
	},
/turf/open/floor/engine,
/area/space)
"ce" = (
/obj/effect/mapping_helpers/simple_pipes/supply/hidden/layer2,
/turf/open/lava/smooth/lava_land_surface,
/area/space)
"cz" = (
/obj/structure/fans/tiny,
/turf/open/lava/smooth/lava_land_surface,
/area/space)
"dI" = (
/obj/structure/closet/crate,
/obj/item/extinguisher{
	pixel_x = -5;
	pixel_y = 5
	},
/obj/item/extinguisher{
	pixel_x = -2;
	pixel_y = 2
	},
/obj/item/extinguisher{
	pixel_x = 1;
	pixel_y = -1
	},
/obj/item/flashlight{
	pixel_x = -5;
	pixel_y = 5
	},
/obj/item/flashlight{
	pixel_x = -2;
	pixel_y = 2
	},
/obj/item/flashlight{
	pixel_x = 1;
	pixel_y = -1
	},
/obj/item/radio/headset/syndicate/alt{
	pixel_x = -3;
	pixel_y = 3
	},
/obj/item/radio/headset/syndicate/alt,
/obj/item/radio/headset/syndicate/alt{
	pixel_x = 3;
	pixel_y = -3
	},
/obj/effect/decal/cleanable/dirt,
/turf/open/floor/plating,
/area/space)
"fl" = (
/obj/machinery/light/small{
	dir = 1
	},
/turf/open/floor/carpet/grimy,
/area/space)
"fF" = (
/obj/structure/grille,
/turf/open/lava/smooth/lava_land_surface,
/area/space)
"he" = (
/obj/structure/rack{
	dir = 8
	},
/obj/item/tank/internals/oxygen/red,
/obj/item/clothing/mask/gas/syndicate,
/obj/item/gun/ballistic/sniper_rifle{
	desc = "A longed ranged weapon meant for killing lavaland fauna."
	},
/turf/open/floor/iron,
/area/space)
"hn" = (
/obj/effect/mapping_helpers/simple_pipes/orange/visible/layer2{
	piping_layer = 3
	},
/obj/machinery/door/airlock/engineering/glass/critical{
	req_access_txt = "150";
	name = "Lavaland Syndicate Engineering"
	},
/turf/open/floor/engine,
/area/space)
"ht" = (
/obj/effect/mob_spawn/human/lavaland_syndicate{
	dir = 8
	},
/turf/open/floor/carpet/grimy,
/area/space)
"hz" = (
/obj/machinery/porta_turret/syndicate{
	dir = 6
	},
/turf/open/lava/smooth/lava_land_surface,
/area/space)
"hV" = (
/obj/structure/reagent_dispensers/beerkeg,
/turf/open/floor/iron/freezer,
/area/space)
"id" = (
/obj/effect/spawner/structure/window/hollow/plasma/reinforced/directional{
	dir = 4
	},
/turf/open/floor/engine,
/area/space)
"is" = (
/obj/machinery/door/airlock/maintenance{
	req_access_txt = "150"
	},
/turf/open/floor/plating,
/area/space)
"jk" = (
/obj/structure/chair/wood/normal{
	dir = 4
	},
/turf/open/floor/wood,
/area/space)
"jB" = (
/obj/machinery/door/firedoor,
/turf/open/lava/smooth/lava_land_surface,
/area/space)
"kt" = (
/obj/machinery/door/airlock/engineering/glass/critical{
	req_access_txt = "150";
	name = "Lavaland Syndicate Engineering"
	},
/turf/open/floor/iron,
/area/space)
"kD" = (
/turf/open/floor/circuit/red,
/area/space)
"kF" = (
/obj/structure/table/wood,
/turf/open/floor/carpet/grimy,
/area/space)
"ls" = (
/obj/effect/mapping_helpers/simple_pipes/general/visible/layer2{
	piping_layer = 3
	},
/turf/open/floor/engine,
/area/space)
"lC" = (
/turf/open/lava/smooth/lava_land_surface,
/area/space)
"lL" = (
/obj/effect/turf_decal/box/white/corners{
	dir = 1
	},
/obj/structure/closet/crate/secure/gear{
	req_access_txt = "150"
	},
/obj/item/clothing/gloves/combat,
/obj/item/clothing/gloves/combat,
/obj/item/clothing/under/syndicate/combat,
/obj/item/clothing/under/syndicate/combat,
/obj/item/storage/belt/military,
/obj/item/storage/belt/military,
/obj/item/clothing/shoes/combat,
/obj/item/clothing/shoes/combat,
/obj/item/clothing/mask/gas/syndicate,
/obj/item/clothing/mask/gas/syndicate,
/obj/item/clothing/glasses/night,
/obj/item/clothing/glasses/night,
/obj/effect/decal/cleanable/dirt,
/obj/effect/decal/cleanable/dirt,
/turf/open/floor/plating,
/area/space)
"lP" = (
/obj/item/toy/plush/lizard_plushie{
	name = "Walks-upon-Embers";
	pixel_x = 5
	},
/turf/open/floor/plating/asteroid/basalt/lava_land_surface,
/area/space)
"mz" = (
/turf/open/floor/carpet/grimy,
/area/space)
"mE" = (
/obj/machinery/washing_machine,
/turf/open/floor/iron,
/area/space)
"mO" = (
/obj/machinery/door/airlock/public/glass{
	name = "Bar"
	},
/turf/open/floor/wood,
/area/space)
"mX" = (
/obj/structure/closet/gimmick/tacticool,
/obj/item/bedsheet/syndie{
	layer = 3
	},
/obj/item/ammo_box/magazine/smgm45,
/obj/item/ammo_box/magazine/m10mm,
/turf/open/floor/carpet/grimy,
/area/space)
"oh" = (
/turf/closed/wall/mineral/plastitanium/nodiagonal,
/area/space)
"pb" = (
/obj/machinery/atmospherics/components/unary/vent_pump/on{
	dir = 1
	},
/turf/open/floor/engine,
/area/space)
"pf" = (
/obj/machinery/airalarm/syndicate{
	dir = 8;
	pixel_x = -24
	},
/turf/open/floor/carpet/grimy,
/area/space)
"qS" = (
/obj/structure/railing/corner,
/turf/open/lava/smooth/lava_land_surface,
/area/space)
"ra" = (
/obj/structure/closet/radiation,
/turf/open/floor/iron,
/area/space)
"rr" = (
/obj/effect/decal/cleanable/dirt,
/obj/effect/turf_decal/stripes/red/line{
	dir = 9
	},
/obj/item/malf_upgrade,
/obj/structure/closet/crate,
/obj/effect/turf_decal/tile/neutral/fourcorners/contrasted,
/turf/open/floor/iron/dark,
/area/space)
"rV" = (
/obj/machinery/door/airlock{
	name = "Bar Storage";
	req_access_txt = "150"
	},
/turf/open/floor/wood,
/area/space)
"sZ" = (
/obj/structure/sign/warning/securearea,
/turf/closed/wall/mineral/plastitanium/nodiagonal,
/area/space)
"tb" = (
/obj/effect/spawner/structure/window/hollow/plasma/reinforced/directional{
	dir = 1
	},
/obj/effect/mapping_helpers/simple_pipes/orange/visible/layer2{
	piping_layer = 3
	},
/turf/open/floor/engine,
/area/space)
"uL" = (
/turf/open/floor/wood,
/area/space)
"vn" = (
/obj/structure/closet/secure_closet/freezer/meat{
	req_access = list(150)
	},
/turf/open/floor/iron/freezer,
/area/space)
"vw" = (
/turf/open/lava/smooth/lava_land_surface,
/turf/open/lava/smooth/lava_land_surface,
/area/space)
"vH" = (
/obj/machinery/atmospherics/components/unary/outlet_injector/on/layer4{
	dir = 8;
	volume_rate = 200;
	piping_layer = 3
	},
/turf/open/floor/plating{
	baseturfs = /turf/open/lava/smooth/lava_land_surface;
	initial_gas_mix = "o2=14;n2=5;co2=13;TEMP=300"
	},
/area/space)
"vI" = (
/obj/effect/spawner/structure/window/hollow/plasma/reinforced/directional{
	dir = 8
	},
/turf/open/floor/engine,
/area/space)
"vX" = (
/obj/machinery/atmospherics/components/unary/thermomachine,
/turf/open/floor/engine,
/area/space)
"wt" = (
/obj/structure/table/wood,
/turf/open/floor/wood,
/area/space)
"wF" = (
/obj/machinery/power/supermatter_crystal/shard/hugbox{
	radio_key = /obj/item/encryptionkey/syndicate;
	name = "syndicate supermatter shard";
	desc = "It costed alot of money for your benefactors to buy this."
	},
/turf/open/floor/engine,
/area/space)
"xe" = (
/obj/machinery/door/window/southleft{
	base_state = "right";
	dir = 1;
	icon_state = "right";
	name = "Bar"
	},
/turf/open/floor/wood,
/area/space)
"yf" = (
/turf/open/floor/iron,
/area/space)
"zI" = (
/obj/structure/railing{
	dir = 4
	},
/turf/open/lava/smooth/lava_land_surface,
/area/space)
"zP" = (
/obj/machinery/atmospherics/components/trinary/filter{
	dir = 4
	},
/turf/open/floor/engine,
/area/space)
"Ab" = (
/obj/machinery/oven{
	dir = 8
	},
/turf/open/floor/wood,
/area/space)
"Ac" = (
/obj/effect/mapping_helpers/simple_pipes/scrubbers/hidden/layer4,
/turf/open/lava/smooth/lava_land_surface,
/area/space)
"An" = (
/obj/effect/mapping_helpers/simple_pipes/orange/visible/layer2{
	piping_layer = 3
	},
/turf/open/floor/engine,
/area/space)
"AA" = (
/obj/structure/chair/wood/normal{
	dir = 1;
	name = "life guard"
	},
/turf/open/floor/wood,
/area/space)
"Bd" = (
/obj/structure/railing,
/turf/open/lava/smooth/lava_land_surface,
/area/space)
"BX" = (
/obj/effect/mapping_helpers/simple_pipes/orange/visible/layer2{
	piping_layer = 3
	},
/turf/closed/wall/mineral/plastitanium/nodiagonal,
/area/space)
"Ch" = (
/obj/structure/chair/stool/bar/directional/south,
/turf/open/floor/wood,
/area/space)
"Co" = (
/obj/structure/railing{
	dir = 1
	},
/turf/open/lava/smooth/lava_land_surface,
/area/space)
"CA" = (
/obj/machinery/atmospherics/components/unary/vent_scrubber/on,
/turf/open/floor/engine,
/area/space)
"CU" = (
/obj/structure/sign/warning/nosmoking,
/turf/closed/wall/mineral/plastitanium/nodiagonal,
/area/space)
"CV" = (
/obj/structure/rack{
	dir = 8
	},
/obj/item/clothing/suit/space/syndicate,
/obj/item/clothing/mask/gas/syndicate,
/obj/item/clothing/head/helmet/space/syndicate,
/obj/item/mining_scanner,
/obj/item/pickaxe,
/turf/open/floor/wood,
/area/space)
"Df" = (
/obj/structure/closet/gimmick/tacticool,
/obj/item/bedsheet/syndie{
	layer = 3
	},
/obj/item/ammo_box/magazine/m10mm,
/turf/open/floor/carpet/grimy,
/area/space)
"Dn" = (
/obj/machinery/atmospherics/components/unary/thermomachine{
	dir = 1
	},
/turf/open/floor/engine,
/area/space)
"GS" = (
/obj/item/toy/plush/beeplushie,
/turf/open/floor/plating/asteroid/basalt/lava_land_surface,
/area/space)
"Ir" = (
/obj/effect/turf_decal/box/white/corners,
/obj/structure/closet/crate/medical,
/obj/item/storage/firstaid/fire{
	pixel_x = 3;
	pixel_y = 3
	},
/obj/item/storage/firstaid/brute,
/obj/item/storage/firstaid/regular{
	pixel_x = -3;
	pixel_y = -3
	},
/obj/item/extrapolator,
/obj/item/extrapolator,
/turf/open/floor/plating,
/area/space)
"IM" = (
/turf/open/space/basic,
/turf/open/lava/smooth/lava_land_surface,
/area/space)
"Jw" = (
/obj/machinery/deepfryer,
/turf/open/floor/wood,
/area/space)
"JK" = (
/obj/machinery/light/small,
/turf/open/floor/carpet/grimy,
/area/space)
"Kg" = (
/obj/machinery/door/airlock/public/glass{
	name = "Bar"
	},
/obj/machinery/door/firedoor,
/turf/open/floor/wood,
/area/space)
"Kr" = (
/obj/structure/chair/fancy/plastic{
	dir = 8
	},
/obj/item/toy/plush/lizard_plushie{
	name = "Shoots-The-Fauna";
	pixel_x = 5
	},
/turf/open/floor/plating,
/area/space)
"KL" = (
/obj/machinery/light/small{
	dir = 1
	},
/obj/machinery/turretid{
	ailock = 1;
	control_area = null;
	dir = 1;
	icon_state = "control_kill";
	lethal = 1;
	name = "Base turret controls";
	pixel_y = 30;
	req_access = null;
	req_access_txt = "150"
	},
/turf/open/floor/circuit/red,
/area/space)
"Lk" = (
/obj/machinery/syndicatebomb/self_destruct{
	anchored = 1
	},
/turf/open/floor/circuit/red,
/area/space)
"LG" = (
/obj/machinery/light/small,
/turf/open/floor/circuit/red,
/area/space)
"Mt" = (
/obj/structure/chair/wood/normal{
	dir = 8
	},
/turf/open/floor/wood,
/area/space)
"Mv" = (
/obj/machinery/door/firedoor,
/turf/open/floor/carpet/grimy,
/area/space)
"MQ" = (
/obj/structure/railing{
	dir = 8
	},
/turf/open/lava/smooth/lava_land_surface,
/area/space)
"MT" = (
/obj/effect/spawner/structure/window/plasma/reinforced,
/obj/structure/grille,
/turf/open/floor/iron,
/area/space)
"MZ" = (
/obj/machinery/griddle,
/turf/open/floor/wood,
/area/space)
"Ne" = (
/obj/structure/closet/crate,
/obj/item/storage/toolbox/electrical{
	pixel_y = 4
	},
/obj/item/storage/toolbox/mechanical,
/turf/open/floor/plating,
/area/space)
"No" = (
/obj/structure/table/wood,
/obj/machinery/microwave,
/turf/open/floor/wood,
/area/space)
"OJ" = (
/obj/effect/decal/cleanable/dirt,
/obj/effect/turf_decal/stripes/red/line{
	dir = 6
	},
/obj/effect/turf_decal/tile/neutral/fourcorners/contrasted,
/turf/open/floor/iron/dark,
/area/space)
"OV" = (
/turf/open/floor/engine,
/area/space)
"Pd" = (
/obj/effect/decal/cleanable/dirt,
/obj/effect/turf_decal/stripes/red/line{
	dir = 10
	},
/obj/effect/turf_decal/tile/neutral/fourcorners/contrasted,
/turf/open/floor/iron/dark,
/area/space)
"Pl" = (
/obj/machinery/door/airlock/external{
	req_access_txt = "150"
	},
/obj/effect/mapping_helpers/airlock/cyclelink_helper,
/obj/structure/fans/tiny,
/turf/open/floor/plating,
/area/space)
"Pm" = (
/obj/effect/spawner/structure/window/hollow/plasma/reinforced/directional,
/obj/effect/mapping_helpers/simple_pipes/general/visible/layer2{
	piping_layer = 3
	},
/turf/open/floor/engine,
/area/space)
"PB" = (
/obj/item/binoculars,
/obj/item/storage/fancy/cigarettes/cigpack_syndicate,
/obj/item/lighter,
/turf/open/floor/plating,
/area/space)
"Qa" = (
/obj/structure/railing/corner{
	dir = 8
	},
/turf/open/lava/smooth/lava_land_surface,
/area/space)
"QE" = (
/obj/structure/table/wood,
/obj/machinery/chem_dispenser/drinks/fullupgrade{
	dir = 4
	},
/turf/open/floor/wood,
/area/space)
"Ri" = (
/obj/effect/turf_decal/box/white/corners{
	dir = 8
	},
/obj/structure/closet/crate/secure/weapon{
	req_access_txt = "150"
	},
/obj/item/ammo_box/c10mm{
	pixel_y = 6
	},
/obj/item/ammo_box/c10mm,
/obj/item/ammo_box/magazine/m10mm{
	pixel_x = -5;
	pixel_y = 5
	},
/obj/item/ammo_box/magazine/m10mm{
	pixel_x = -2;
	pixel_y = 2
	},
/obj/item/ammo_box/magazine/m10mm{
	pixel_x = 1;
	pixel_y = -1
	},
/obj/item/ammo_box/magazine/m10mm{
	pixel_x = 4;
	pixel_y = -4
	},
/obj/machinery/atmospherics/components/unary/vent_pump/on,
/turf/open/floor/plating,
/area/space)
"RO" = (
/turf/open/floor/plating,
/area/space)
"Sd" = (
/turf/open/floor/iron/freezer,
/area/space)
"Sr" = (
/obj/machinery/light_switch/directional/west,
/turf/open/floor/carpet/grimy,
/area/space)
"SI" = (
/obj/structure/chair/wood/normal,
/turf/open/floor/wood,
/area/space)
"SK" = (
/obj/effect/decal/cleanable/dirt,
/obj/effect/turf_decal/stripes/red/line{
	dir = 5
	},
/obj/structure/filingcabinet,
/obj/item/folder/syndicate/mining,
/obj/effect/turf_decal/tile/neutral/fourcorners/contrasted,
/turf/open/floor/iron/dark,
/area/space)
"ST" = (
/obj/structure/railing/corner{
	dir = 1
	},
/turf/open/lava/smooth/lava_land_surface,
/area/space)
"SW" = (
/obj/structure/sign/warning/xeno_mining{
	pixel_x = -32
	},
/obj/structure/sign/warning/fire{
	pixel_x = 32
	},
/obj/machinery/light/small{
	dir = 8
	},
/turf/open/floor/plating,
/area/space)
"TV" = (
/obj/structure/fans/tiny,
/obj/machinery/door/airlock/external{
	req_access_txt = "150"
	},
/obj/effect/mapping_helpers/airlock/cyclelink_helper{
	dir = 1
	},
/turf/open/floor/plating,
/area/space)
"Wn" = (
/obj/effect/turf_decal/tile/neutral/fourcorners/contrasted,
/obj/structure/sign/warning/explosives/alt,
/turf/closed/wall/mineral/plastitanium/nodiagonal,
/area/space)
"Wu" = (
/obj/structure/fans/tiny,
/obj/machinery/door/airlock/hatch{
	req_access_txt = "150"
	},
/turf/open/floor/plating,
/area/space)
"WG" = (
/obj/structure/grille,
/obj/structure/window/plastitanium,
/turf/open/floor/plating,
/area/space)
"WO" = (
/obj/structure/window/plastitanium,
/turf/open/lava/smooth/lava_land_surface,
/area/space)
"Xk" = (
/obj/effect/turf_decal/box/white/corners{
	dir = 4
	},
/obj/structure/closet/crate,
/obj/item/storage/box/donkpockets{
	pixel_x = -2;
	pixel_y = 6
	},
/obj/item/storage/box/donkpockets{
	pixel_y = 3
	},
/obj/item/storage/box/donkpockets{
	pixel_x = 2
	},
/turf/open/floor/plating,
/area/space)
"Yn" = (
/obj/structure/table/wood,
/obj/machinery/chem_dispenser/drinks/beer/fullupgrade{
	dir = 4
	},
/turf/open/floor/wood,
/area/space)
"Yw" = (
/obj/machinery/door/airlock/vault{
	id_tag = "syndie_lavaland_vault";
	req_access_txt = "150"
	},
/turf/open/floor/iron,
/area/space)
"Yz" = (
/obj/structure/closet/secure_closet/freezer/kitchen{
	req_access = list(150)
	},
/turf/open/floor/iron/freezer,
/area/space)
"Zz" = (
/obj/structure/railing/corner{
	dir = 4
	},
/turf/open/lava/smooth/lava_land_surface,
/area/space)

(1,1,1) = {"
lC
lC
lC
lC
lC
lC
lC
lC
lC
lC
lC
lC
lC
lC
lC
lC
lC
lC
lC
lC
lC
lC
lC
lC
lC
lC
lC
lC
lC
lC
lC
lC
lC
lC
lC
lC
lC
lC
lC
lC
lC
lC
lC
lC
lC
lC
lC
lC
lC
lC
"}
(2,1,1) = {"
lC
lC
lC
lC
lC
lC
lC
lC
lC
lC
lC
lC
lC
lC
lC
lC
lC
lC
lC
lC
lC
lC
lC
lC
lC
lC
lC
lC
lC
lC
lC
lC
lC
lC
lC
lC
lC
lC
lC
lC
lC
lC
lC
lC
lC
lC
lC
lC
lC
lC
"}
(3,1,1) = {"
lC
lC
lC
lC
lC
lC
lC
lC
lC
lC
lC
lC
lC
lC
lC
lC
lC
lC
lC
lC
lC
lC
lC
lC
lC
lC
lC
lC
lC
lC
lC
lC
lC
lC
lC
lC
lC
lC
lC
lC
lC
lC
lC
lC
lC
lC
lC
lC
lC
lC
"}
(4,1,1) = {"
lC
lC
lC
lC
lC
lC
lC
lC
lC
lC
lC
lC
lC
lC
lC
lC
lC
lC
lC
lC
lC
lC
lC
lC
lC
lC
lC
lC
lC
lC
lC
lC
lC
lC
lC
lC
lC
lC
lC
lC
lC
lC
lC
lC
lC
lC
lC
lC
lC
lC
"}
(5,1,1) = {"
lC
lC
lC
lC
lC
lC
lC
lC
lC
lC
lC
lC
lC
lC
lC
lC
lC
lC
lC
lC
lC
lC
lC
lC
lC
lC
lC
lC
lC
lC
lC
lC
lC
lC
lC
lC
lC
lC
lC
lC
lC
lC
lC
lC
lC
lC
lC
lC
lC
lC
"}
(6,1,1) = {"
lC
lC
lC
lC
lC
lC
lC
lC
lC
lC
lC
lC
lC
lC
lC
lC
lC
lC
lC
lC
lC
lC
lC
lC
lC
lC
lC
lC
lC
lC
lC
lC
lC
lC
lC
lC
lC
lC
lC
lC
lC
lC
lC
lC
lC
lC
lC
lC
lC
lC
"}
(7,1,1) = {"
lC
lC
lC
lC
lC
lC
lC
oh
oh
oh
oh
oh
oh
oh
oh
oh
oh
oh
lC
lC
lC
lC
lC
lC
lC
lC
lC
lC
lC
lC
lC
lC
lC
lC
lC
lC
lC
lC
lC
lC
lC
lC
lC
lC
lC
lC
lC
lC
lC
lC
"}
(8,1,1) = {"
lC
lC
lC
lC
lC
lC
oh
oh
yf
yf
yf
yf
yf
yf
yf
yf
yf
yf
lC
lC
lC
lC
lC
lC
lC
lC
lC
lC
lC
lC
lC
lC
lC
lC
lC
lC
lC
lC
lC
lC
lC
lC
lC
lC
lC
lC
lC
lC
lC
lC
"}
(9,1,1) = {"
lC
lC
lC
lC
lC
lC
oh
yf
yf
yf
yf
yf
yf
yf
yf
yf
yf
yf
lC
lC
lC
lC
lC
lC
lC
lC
lC
IM
IM
lC
lC
lC
lC
lC
lC
lC
lC
lC
lC
lC
lC
lC
lC
lC
lC
lC
lC
lC
lC
lC
"}
(10,1,1) = {"
lC
lC
lC
lC
lC
lC
oh
yf
yf
yf
yf
yf
yf
yf
yf
yf
yf
yf
lC
lC
lC
lC
lC
lC
lC
lC
lC
lC
lC
lC
lC
lC
lC
lC
lC
lC
lC
lC
lC
lC
lC
lC
lC
lC
lC
lC
lC
lC
lC
lC
"}
(11,1,1) = {"
lC
lC
lC
lC
lC
lC
oh
yf
yf
yf
yf
yf
yf
yf
yf
yf
yf
yf
lC
lC
lC
lC
lC
lC
lC
lC
lC
lC
lC
lC
lC
lC
lC
lC
lC
lC
lC
lC
lC
lC
lC
lC
lC
lC
lC
lC
lC
lC
lC
lC
"}
(12,1,1) = {"
lC
lC
lC
lC
lC
lC
oh
yf
yf
yf
yf
yf
yf
yf
yf
yf
yf
yf
lC
lC
lC
lC
lC
lC
lC
lC
lC
lC
lC
lC
lC
lC
lC
lC
lC
lC
lC
lC
lC
lC
lC
lC
lC
lC
lC
lC
lC
lC
lC
lC
"}
(13,1,1) = {"
lC
lC
lC
lC
lC
lC
oh
yf
yf
yf
yf
yf
yf
yf
yf
yf
yf
yf
lC
lC
lC
lC
lC
lC
lC
lC
lC
lC
lC
lC
lC
lC
lC
lC
lC
lC
lC
lC
lC
lC
lC
lC
lC
lC
lC
lC
lC
lC
lC
lC
"}
(14,1,1) = {"
lC
lC
lC
lC
lC
lC
oh
yf
yf
yf
yf
yf
yf
yf
yf
yf
yf
yf
lC
lC
lC
lC
lC
lC
lC
lC
lC
lC
lC
lC
lC
lC
lC
lC
lC
lC
lC
lC
lC
lC
lC
lC
lC
lC
lC
lC
lC
lC
lC
lC
"}
(15,1,1) = {"
lC
lC
lC
lC
lC
lC
oh
yf
yf
yf
yf
yf
yf
yf
yf
yf
yf
yf
lC
lC
lC
lC
lC
lC
lC
lC
lC
lC
lC
lC
lC
lC
lC
lC
lC
lC
lC
lC
lC
lC
lC
lC
lC
lC
lC
lC
lC
lC
lC
lC
"}
(16,1,1) = {"
lC
lC
lC
lC
lC
lC
oh
yf
yf
yf
yf
yf
yf
yf
yf
yf
yf
yf
yf
yf
yf
oh
lC
IM
lC
lC
lC
lC
lC
lC
lC
lC
lC
lC
lC
lC
lC
lC
lC
lC
lC
lC
lC
lC
lC
lC
lC
lC
lC
lC
"}
(17,1,1) = {"
lC
lC
lC
lC
lC
lC
oh
oh
yf
yf
yf
yf
yf
yf
yf
yf
yf
yf
yf
yf
yf
oh
lC
vw
lC
lC
lC
lC
lC
lC
lC
lC
lC
lC
lC
lC
lC
lC
lC
lC
lC
lC
lC
lC
lC
lC
lC
lC
lC
lC
"}
(18,1,1) = {"
lC
lC
lC
lC
lC
lC
lC
oh
oh
oh
oh
oh
oh
oh
oh
oh
oh
oh
yf
yf
yf
oh
lC
vw
lC
lC
lC
lC
lC
lC
lC
lC
lC
lC
lC
lC
lC
lC
lC
lC
lC
lC
lC
lC
lC
lC
lC
lC
lC
lC
"}
(19,1,1) = {"
lC
lC
lC
lC
lC
lC
lC
lC
lC
lC
lC
lC
lC
lC
lC
lC
lC
WG
yf
yf
yf
oh
IM
IM
lC
lC
lC
qS
zI
zI
zI
Zz
lC
lC
lC
WG
WG
oh
oh
oh
oh
lC
lC
lC
lC
lC
lC
lC
lC
lC
"}
(20,1,1) = {"
lC
lC
lC
lC
lC
lC
lC
oh
oh
oh
oh
oh
oh
oh
GS
lC
lC
WG
yf
yf
yf
oh
oh
oh
Wn
oh
oh
Bd
PB
Kr
RO
Co
lC
lC
WG
WG
uL
jk
uL
uL
oh
oh
lC
lC
lC
lC
lC
lC
lC
lC
"}
(21,1,1) = {"
lC
lC
lC
lC
lC
lC
oh
oh
id
id
id
OV
OV
oh
oh
lP
lC
WG
yf
yf
yf
oh
oh
rr
kD
Pd
oh
Bd
RO
RO
RO
Co
lC
WG
WG
uL
SI
wt
AA
uL
CV
oh
lC
lC
lC
lC
lC
lC
lC
lC
"}
(22,1,1) = {"
lC
lC
lC
lC
lC
lC
oh
Pm
pb
wF
CA
tb
OV
OV
oh
oh
lC
WG
yf
yf
yf
oh
oh
KL
Lk
LG
oh
Bd
RO
RO
RO
Co
WG
WG
uL
uL
uL
Mt
uL
uL
CV
oh
oh
sZ
lC
lC
lC
lC
lC
lC
"}
(23,1,1) = {"
lC
lC
lC
lC
lC
lC
oh
ls
vI
vI
bV
An
OV
OV
OV
oh
lC
WG
yf
yf
yf
oh
oh
SK
kD
OJ
oh
Qa
MQ
RO
MQ
ST
WG
uL
uL
uL
uL
uL
uL
uL
uL
Pl
SW
TV
lC
lC
lC
lC
lC
lC
"}
(24,1,1) = {"
lC
lC
lC
lC
lC
lC
oh
ls
OV
OV
An
MT
MT
MT
MT
oh
WG
WG
yf
yf
yf
oh
oh
sZ
Yw
sZ
oh
oh
oh
Wu
oh
oh
oh
uL
Ch
wt
wt
Yn
QE
oh
oh
oh
oh
sZ
lC
lC
lC
lC
lC
lC
"}
(25,1,1) = {"
lC
lC
lC
lC
lC
lC
oh
ls
Dn
vX
An
MT
yf
yf
yf
MT
yf
yf
yf
yf
yf
yf
yf
yf
yf
yf
yf
yf
he
yf
yf
yf
Kg
uL
Ch
wt
uL
uL
uL
MZ
oh
lC
lC
lC
lC
lC
lC
lC
lC
lC
"}
(26,1,1) = {"
lC
lC
lC
lC
lC
lC
oh
ls
Dn
Dn
An
MT
yf
yf
yf
kt
yf
yf
yf
yf
yf
yf
yf
yf
yf
yf
yf
yf
yf
yf
yf
yf
Kg
uL
Ch
wt
uL
uL
uL
Jw
oh
lC
lC
lC
lC
lC
lC
lC
lC
lC
"}
(27,1,1) = {"
lC
lC
lC
lC
lC
lC
oh
ls
OV
OV
An
MT
yf
yf
yf
MT
yf
yf
yf
yf
yf
yf
yf
yf
yf
yf
yf
yf
yf
yf
yf
yf
mO
uL
Ch
wt
uL
uL
uL
No
oh
lC
lC
lC
lC
lC
lC
lC
lC
lC
"}
(28,1,1) = {"
lC
lC
lC
lC
lC
lC
oh
ls
OV
OV
zP
MT
yf
yf
ra
oh
WG
WG
yf
yf
yf
yf
yf
yf
yf
yf
yf
oh
oh
oh
oh
oh
oh
uL
uL
xe
uL
Ab
uL
bF
oh
lC
lC
lC
lC
lC
lC
lC
lC
lC
"}
(29,1,1) = {"
lC
lC
lC
lC
lC
lC
oh
ls
ls
ls
ls
MT
yf
yf
ra
oh
lC
WG
yf
yf
yf
yf
yf
yf
yf
yf
yf
is
RO
RO
RO
RO
oh
oh
oh
oh
oh
oh
rV
oh
oh
lC
lC
lC
lC
lC
lC
lC
lC
lC
"}
(30,1,1) = {"
lC
lC
lC
lC
lC
lC
oh
OV
OV
OV
OV
MT
yf
ra
oh
oh
lC
WG
yf
oh
oh
oh
oh
yf
yf
yf
oh
oh
oh
oh
RO
RO
lL
Ri
oh
Sd
Sd
Sd
Sd
Sd
oh
lC
lC
lC
lC
lC
lC
lC
lC
lC
"}
(31,1,1) = {"
lC
lC
lC
lC
lC
lC
oh
oh
OV
OV
OV
hn
yf
oh
oh
lC
lC
lC
yf
oh
pf
Sr
Mv
yf
yf
yf
Mv
Sr
pf
oh
RO
RO
dI
Ne
oh
Sd
Sd
Sd
Sd
Sd
oh
lC
lC
lC
lC
lC
lC
lC
lC
lC
"}
(32,1,1) = {"
lC
lC
lC
lC
lC
lC
lC
oh
oh
oh
oh
BX
oh
oh
lC
lC
lC
lC
yf
oh
fl
Df
oh
yf
yf
yf
oh
mX
JK
oh
RO
RO
Xk
Ir
oh
Sd
Sd
hV
Yz
vn
oh
lC
lC
lC
lC
lC
lC
lC
lC
lC
"}
(33,1,1) = {"
lC
lC
lC
lC
lC
lC
lC
lC
lC
lC
lC
vH
lC
lC
lC
lC
lC
lC
yf
oh
mz
mz
oh
yf
yf
yf
CU
mz
mz
oh
RO
RO
oh
oh
oh
is
oh
oh
oh
oh
oh
lC
lC
lC
lC
lC
lC
lC
lC
lC
"}
(34,1,1) = {"
lC
lC
lC
lC
lC
lC
lC
lC
lC
lC
lC
lC
lC
lC
lC
lC
lC
lC
yf
oh
aT
kF
oh
mE
yf
yf
oh
ht
kF
oh
RO
RO
RO
RO
RO
RO
oh
lC
lC
lC
lC
lC
lC
lC
lC
lC
lC
lC
lC
lC
"}
(35,1,1) = {"
lC
lC
lC
lC
lC
lC
lC
lC
lC
lC
lC
lC
lC
lC
lC
lC
lC
lC
yf
oh
oh
oh
oh
yf
yf
yf
oh
oh
oh
oh
is
oh
oh
oh
oh
oh
oh
lC
lC
lC
lC
lC
lC
lC
lC
lC
lC
lC
lC
lC
"}
(36,1,1) = {"
lC
lC
lC
lC
lC
lC
lC
lC
lC
lC
lC
lC
lC
lC
lC
lC
lC
lC
yf
yf
yf
yf
yf
yf
yf
yf
yf
yf
lC
lC
lC
lC
lC
lC
lC
lC
lC
lC
lC
lC
lC
lC
lC
lC
lC
lC
lC
lC
lC
lC
"}
(37,1,1) = {"
lC
lC
lC
lC
lC
lC
lC
lC
lC
lC
lC
lC
lC
lC
lC
lC
lC
lC
yf
yf
yf
yf
yf
yf
yf
yf
yf
yf
lC
lC
lC
lC
lC
lC
lC
lC
lC
lC
lC
lC
lC
lC
lC
lC
lC
lC
lC
lC
lC
lC
"}
(38,1,1) = {"
lC
lC
lC
lC
lC
lC
lC
lC
lC
lC
lC
lC
lC
lC
lC
lC
lC
lC
lC
lC
lC
lC
lC
lC
lC
lC
lC
lC
lC
lC
lC
lC
lC
lC
lC
lC
lC
lC
lC
lC
lC
lC
lC
lC
lC
lC
lC
lC
lC
lC
"}
(39,1,1) = {"
lC
lC
lC
lC
lC
lC
lC
lC
lC
lC
lC
lC
lC
lC
lC
lC
lC
lC
lC
lC
lC
lC
lC
lC
lC
lC
lC
lC
lC
lC
lC
lC
lC
lC
lC
lC
lC
lC
lC
lC
lC
lC
lC
lC
lC
lC
lC
lC
lC
lC
"}
(40,1,1) = {"
lC
lC
lC
lC
lC
lC
lC
lC
lC
lC
lC
lC
lC
lC
lC
lC
lC
lC
lC
lC
lC
lC
lC
lC
lC
lC
lC
lC
lC
lC
lC
lC
lC
lC
lC
lC
lC
lC
lC
lC
lC
lC
lC
lC
lC
lC
lC
lC
lC
lC
"}
(41,1,1) = {"
lC
lC
lC
lC
lC
lC
lC
lC
lC
lC
lC
lC
lC
lC
lC
lC
lC
lC
lC
lC
lC
lC
lC
lC
lC
lC
lC
lC
lC
lC
lC
lC
lC
lC
lC
lC
lC
lC
lC
lC
lC
lC
lC
lC
lC
lC
lC
lC
lC
lC
"}
(42,1,1) = {"
lC
lC
lC
lC
lC
lC
lC
lC
lC
lC
lC
lC
lC
lC
lC
lC
lC
lC
lC
lC
lC
lC
lC
lC
lC
lC
lC
lC
lC
lC
lC
lC
lC
lC
lC
lC
lC
lC
lC
lC
lC
lC
lC
lC
lC
lC
lC
lC
lC
lC
"}
(43,1,1) = {"
lC
lC
lC
lC
lC
lC
lC
lC
lC
lC
lC
lC
lC
lC
lC
lC
lC
lC
lC
lC
lC
lC
lC
lC
lC
lC
lC
lC
lC
lC
lC
lC
lC
lC
lC
lC
lC
lC
lC
lC
lC
lC
lC
lC
lC
lC
lC
lC
lC
lC
"}
(44,1,1) = {"
lC
mz
jB
lC
lC
lC
lC
lC
lC
lC
lC
lC
lC
lC
lC
lC
lC
lC
lC
lC
lC
lC
lC
lC
lC
lC
lC
lC
lC
lC
lC
lC
lC
lC
lC
lC
lC
lC
lC
lC
lC
lC
lC
lC
lC
lC
lC
lC
lC
lC
"}
(45,1,1) = {"
lC
uL
oh
lC
lC
lC
lC
lC
lC
lC
lC
lC
lC
lC
lC
lC
lC
lC
lC
lC
lC
lC
lC
lC
lC
lC
lC
lC
lC
lC
lC
lC
lC
lC
lC
lC
lC
lC
lC
lC
lC
lC
lC
lC
lC
lC
lC
lC
lC
lC
"}
(46,1,1) = {"
hz
WO
fF
lC
lC
lC
lC
lC
lC
lC
lC
lC
lC
lC
lC
lC
lC
lC
lC
lC
lC
lC
lC
lC
lC
lC
lC
lC
lC
lC
lC
lC
lC
lC
lC
lC
lC
lC
lC
lC
lC
lC
lC
lC
lC
lC
lC
lC
lC
lC
"}
(47,1,1) = {"
lC
cz
RO
lC
lC
lC
lC
lC
lC
lC
lC
lC
lC
lC
lC
lC
lC
lC
lC
lC
lC
lC
lC
lC
lC
lC
lC
lC
lC
lC
lC
lC
lC
lC
lC
lC
lC
lC
lC
lC
lC
lC
lC
lC
lC
lC
lC
lC
lC
lC
"}
(48,1,1) = {"
lC
lC
ce
lC
lC
lC
lC
lC
lC
lC
lC
lC
lC
lC
lC
lC
lC
lC
lC
lC
lC
lC
lC
lC
lC
lC
lC
lC
lC
lC
lC
lC
lC
lC
lC
lC
lC
lC
lC
lC
lC
lC
lC
lC
lC
lC
lC
lC
lC
lC
"}
(49,1,1) = {"
lC
lC
Ac
lC
lC
lC
lC
lC
lC
lC
lC
lC
lC
lC
lC
lC
lC
lC
lC
lC
lC
lC
lC
lC
lC
lC
lC
lC
lC
lC
lC
lC
lC
lC
lC
lC
lC
lC
lC
lC
lC
lC
lC
lC
lC
lC
lC
lC
lC
lC
"}
(50,1,1) = {"
lC
lC
lC
lC
lC
lC
lC
lC
lC
lC
lC
lC
lC
lC
lC
lC
lC
lC
lC
lC
lC
lC
lC
lC
lC
lC
lC
lC
lC
lC
lC
lC
lC
lC
lC
lC
lC
lC
lC
lC
lC
lC
lC
lC
lC
lC
lC
lC
lC
lC
"}
